keyboard	noun	/ˈkiːbɔːd/	(etc.) A set of keys used to operate a typewriter, computer etc.
computer	noun	/kəmˈpjuːtə/	A person employed to perform computations; one who computes.
perform	verb	/pəˈfɔːm/	To do something; to execute.
something	noun	/ˈsamθɪŋ/	An object whose nature is yet to be defined.
object	noun	/ˈɒb.d͡ʒɛkt/	A thing that has physical existence.
existence	noun	/ɛɡ.ˈzɪs.təns/	The state of being, existing, or occurring; beinghood.
evil	noun	/ˈivəl/	Moral badness; wickedness; malevolence; the forces or behaviors that are the opposite or enemy of good.
lacks	noun	/læks/	A defect or failing; moral or spiritual degeneracy.
space	noun	/speɪs/	(heading) Of time.
time	noun	/tɑem/	The inevitable progression into the future with the passing of present and past events.
fan	noun	/fæn/	A hand-held device consisting of concertinaed material, or slats of material, gathered together at one end, that may be opened out into the shape of a sector of a circle and waved back and forth in order to move air towards oneself and cool oneself.
officer	noun	/ˈɑfɪsɚ/	One who has a position of authority in a hierarchical organization, especially in military, police or government organizations.
office	noun	/ˈɑfɪs/	A ceremonial duty or service, particularly:
bed	noun	/bed/	A piece of furniture, usually flat and soft, on which to rest or sleep.
bet	noun	/ˈbɛt/	A wager, an agreement between two parties that a stake (usually money) will be paid by the loser to the winner (the winner being the one who correctly forecast the outcome of an event).
shirt	noun	/ʃɜːt/	An article of clothing that is worn on the upper part of the body, and often has sleeves, either long or short, that cover the arms.
hello	noun	/həˈləʊ/	"Hello!" or an equivalent greeting.
translate	noun	/ˈtɹɛnzlæet/	In Euclidean spaces: a set of points obtained by adding a given fixed vector to each point of a given set.
translation	noun	/tɹæns-/	The act of translating, in its various senses:
various	adjective	/ˈvɛə.ɹi.əs/	Having a broad range (of different elements).
broad	noun	/bɹɑd/	A shallow lake, one of a number of bodies of water in eastern Norfolk and Suffolk.
water	noun	/ˈwoːtə/	A substance (of molecular formula H₂O) found at room temperature and pressure as a clear liquid; it is present naturally as rain, and found in rivers, lakes and seas; its solid form is ice and its gaseous form is steam.
non	adverb	N/A	To no extent, in no way.
none	noun	/nɒn/	A person without religious affiliation.
person	noun	/ˈpɜːsən/	An individual; usually a human being.
human	noun	/ˈhjuː.mən/	A human being, whether man, woman or child.
phone	noun	/fəʊ̯n/	A device for transmitting conversations and other sounds in real time across distances, now often a small portable unit also capable of running software etc.
calculator	noun	/kæl.kjə.leɪ.təɹ/	A mechanical or electronic device that performs mathematical calculations.
