source	noun	/sɔːs/	The person, place or thing from which something (information, goods, etc.) comes or is acquired.
finding	verb	/ˈfaɪndɪŋ/	To encounter or discover by accident; to happen upon.
found	verb	/faʊnd/	To encounter or discover by accident; to happen upon.
title	noun	/ˈtaɪtl̩/	A prefix (honorific) or suffix (post-nominal) added to a person's name to signify either veneration, official position or a professional or academic qualification. See also
prefix	noun	N/A	Something placed before another
premium	noun	/ˈpɹimiəm/	A prize or award.
triple	noun	/ˈtɹɪpl/	Three times or thrice the number, amount, size, etc
fort	noun	/fɔːt/	A fortified defensive structure stationed with troops.
fallen	verb	/ˈfɔːlən/	(heading) To be moved downwards.
falling	verb	/ˈfɔːlɪŋ/	(heading) To be moved downwards.
success	noun	/səkˈsɛs/	The achievement of one's aim or goal.
achieve	verb	/əˈtʃiːv/	To succeed in something, now especially in academic performance.
act	noun	/æk/	Something done, a deed.
activity	noun	/ækˈtɪ.və.ti/	The state or quality of being active; activeness.
duo	noun	/ˈdjuː.əʊ/	Two people who work or collaborate together as partners; especially, those who perform music together.
person	noun	/ˈpɜːsən/	An individual; usually a human being.
perk	noun	/pɝk/	Perquisite.
mosquito	noun	/məˈski.toʊ/	A small flying insect of the family Culicidae, the females of which bite humans and animals and suck blood, leaving an itching bump on the skin, and sometimes carrying diseases like malaria and yellow fever.
environment	noun	/-mɪnt/	The surroundings of, and influences on, a particular item of interest.
enormous	adjective	/ɪˈnɔː(ɹ)məs/	Deviating from the norm; unusual, extraordinary.
exchange	noun	/ɛksˈtʃeɪndʒ/	An act of exchanging or trading.
exactly	adverb	/ɪɡˈzæk(t)li/	(manner) without approximation; precisely.
passive	noun	/ˈpæs.ɪv/	(grammar) The passive voice of verbs.
easier	adjective	/ˈiː.zi.ə/	Comfortable; at ease.
conquer	verb	/ˈkɒŋkə/	To defeat in combat; to subjugate.
achievement	noun	/əˈtʃiːvmənt/	The act of achieving or performing; a successful performance; accomplishment
achieving	verb	/əˈtʃiːvɪŋ/	To succeed in something, now especially in academic performance.
attack	noun	/əˈtæk/	An attempt to cause damage, injury to, or death of opponent or enemy.
fight	verb	[fʌɪt]	To contend in physical conflict, either singly or in war, battle etc.
fought	verb	/fɔːt/	To contend in physical conflict, either singly or in war, battle etc.
afford	verb	/əˈfɔːd/	To incur, stand, or bear without serious detriment, as an act which might under other circumstances be injurious;—with an auxiliary, as can, could, might, etc.; to be able or rich enough.
affordable	adjective	/əˈfɔː(ɹ).də.bəl/	Able to be afforded; inexpensive or reasonably priced.
relax	verb	/ɹɪˈlæks/	To calm down.
relaxing	verb	N/A	To calm down.
relaxed	verb	/ɹɪˈlækst/	To calm down.
camping	verb	/ˈkæmpɪŋ/	To live in a tent or similar temporary accommodation.
toxic	adjective	/ˈtɒk.sɪk/	Having a chemical nature that is harmful to health or lethal if consumed or otherwise entering into the body in sufficient quantities.
pollute	verb	/pəˈljuːt/	To make something harmful, especially by the addition of some unwanted product.
pollution	noun	/pəˈl(j)uːʃn̩/	The desecration of something holy or sacred; defilement, profanation.
pollutant	noun	N/A	A foreign substance that makes something dirty, or impure, especially waste from human activities.
package	noun	/ˈpækɪdʒ/	Something which is packed, a parcel, a box, an envelope.
can	verb	/ˈkæn/	(auxiliary verb, defective) To know how to; to be able to.
fuel	noun	/ˈfjuːl/	Substance consumed to provide energy through combustion, or through chemical or nuclear reaction.
fossil	noun	/ˈfɒsəl/	The mineralized remains of an animal or plant.
marl	noun	/mɑːl/	A mixed earthy substance, consisting of carbonate of lime, clay, and possibly sand, in very variable proportions, and accordingly designated as calcareous, clayey, or sandy.
mar	noun	/mɑː(ɹ)/	A blemish.
sunny	noun	/ˈsʌni/	A sunfish.
bit	noun	/bɪt/	A piece of metal placed in a horse's mouth and connected to the reins to direct the animal.
bite	noun	/bʌɪt/	The act of biting.
bat	noun	/bæt/	Any of the flying mammals of the order Chiroptera, usually small and nocturnal, insectivorous or frugivorous.
dog	noun	/dɑɡ/	A mammal, Canis familiaris or Canis lupus familiaris, that has been domesticated for thousands of years, of highly variable appearance due to human breeding.
goose	noun	/ˈɡuːs/	Any of various grazing waterfowl of the family Anatidae, which have feathers and webbed feet and are capable of flying, swimming, and walking on land, and which are bigger than ducks.
waterfowl	noun	N/A	Any of the birds, such as ducks, geese and swans, that spend most of their non-flying time on water; especially those of the family Anatidae.
swan	noun	/swɒn/	Any of various species of large, long-necked waterfowl, of genus Cygnus (bird family: Anatidae), most of which have white plumage.
genus	noun	/ˈdʒiːnəs/	A rank in the classification of organisms, below family and above species; a taxon at that rank.
rank	adjective	/ɹæŋk/	Strong of its kind or in character; unmitigated; virulent; thorough; utter (used of negative things).
character	noun	/ˈkæɹəktə/	A being involved in the action of a story.
involved	verb	/ɪnˈvɒlvd/	To roll or fold up; to wind round; to entwine.
decade	noun	/dəˈkeɪd/	A group, set, or series of ten , particularly:
died	verb	/daɪd/	To stop living; to become dead; to undergo death.
dead	noun	/diːd/	(with "the", a demonstrative, or a possessive) Those who have died.
bedroom	noun	/ˈbɛdɹʊm/	A room in a house where a bed is kept for sleeping.
bathroom	noun	/ˈbæθ.ɹuːm/	A room containing a shower and/or bathtub, and (typically but not necessarily) a toilet.
trace	noun	/tɹeɪs/	An act of tracing.
track	noun	/tɹæk/	A mark left by something that has passed along.
training	verb	/ˈtɹeɪnɪŋ/	To practice an ability.
teleport	noun	/ˈtɛləpɔː(ɹ)t/	A teleporter.
telephone	noun	/ˈtɛləfəʊn/	A telecommunication device (originally mechanical, and now electronic) used for two-way talking with another person (now often shortened to phone).
mobile	noun	/ˈməʊbaɪl/	A kinetic sculpture or decorative arrangement made of items hanging so that they can move independently from each other.
